111111111
111110
000P
E000111
111111111