111111111
1000P0001
111111111
10E000001
100000011
111C10001
111111111