1111111111
10E0C0P0C1
1111111111
1010010101
1111111111