1111111111111111111111111111111111
10000000000000C00000C0000000000011
1010010100100000101001000000010101
1010010010101010001010000000001011
1P0000000C00C0000000000000E00000C1
1111111111111111111111111111111111