11111111111111111111111111111111111
1000000C001000000000000100011111111
10010C00000000001000100000011111111
10100000110001001000C01000011111111
10001010000000011000000000011111111
1000010000E000111100001000011111111
1000010000000C000011110010011111111
1000001100001000000P010000011111111
100C00011100100C0001000000011111111
10000C00010000000000010000000000001
11111111111111111111111111111111101
11111111111111CCCCCCCCCCCCCCCCCC101
11111111111111CCCCCCCCCCCCCCCCCC101
11111111111111CCCCCCCCCCCCCCCCCC001
11111111111111CCCCCCCCCCCCCCCCCC101
11111111111111CCCCCCCCCCCCCCCCCC101
11111111111111111111111111111111111
11111111111111111111111111111111111